1111111111111111111111111111111111
1000000000000CCC00000C000000000001
1010010100100000101001000000010101
1111110111111111111111111111111111
1P00E0000C00C0000000000000000000C1
1111111111111111111111111111111111