1111111111111
1C010000000C1
1000011011001
1P0z11E010001
1111111111111